111111111111111111111111111111111111111
10000000000C0000000000000000000000000R1
1000000000000000000000000000000000000R1
1P0000E000000000000000000000000000000R1
1000000C00000000000000000000000000000R1
10000000C0000000000000000000000000000R1
1000000000000000000000000000000000000R1
1000000000000000000000000000000000000R1
1000000000000000000000000000000000000R1
1000000000000000000000000000000000000R1
1000000000000000000000000000000000000R1
111111111111111111111111111111111111111
