111111111111111111111111111111111111111
10000000000C000000000000000000000000001
100000000000000000000000000000000000001
1P0000E00000000000000000000000000000001
1000000C0000000000000000000000000000001
10000000C0000000000000000R0000000000001
100000000000000000000000000000000000001
100000000000000000000000000000000000001
100000000000000000000000000000000000001
100000000000000000000000000000000000001
100000000000000000000000000000000000001
111111111111111111111111111111111111111
