1111111111111
1NN1NNNNNNNC1
1NNNN11111NN1
1PNN11ENNNNN1
1111111111111
